go=gitmek
come=gelmek
run=koþmak
walk=yürümek
move=hareket etmak
raise=kaldýrmak
putdown=indirmek
speak=konuþmak
tell=söylemek
say=demek
have=olmak sahip olmak
get=almak
take=almak
eat=yemek
drink=içmek
taste=tadmak
smell=koklamak
buy=satýn almak
sell=satmak
send=göndermek
delivar=daðýtmak
understand=anlamak
listen=dinlemek
read=okumak
write=yazmak
repead=tekrarlamak
close=kapatmak
open=açmak
trun=dönmek
turnon=açmak
turnoff=kapatmak
svitchon=açmak ýþýk
svitchoff=kapatmak ýþýk
plugin=pirize takmak
clean=temizlemek
mase=yapmak
do=yapmaz 
drive=sürmek
ride=sürmek
fly=uçmak
lose=kaybetmak
find=bulmak
give=vermek
hear=duymak
see=görmek
look=bakmak
like=hoþlanmak
hale=nefret etmek
enjoy=tadýný çýkart
know=bilmek
think=düþünmek
want=istemek
pay=ödemek
need=ihdiyacý olamak
prefer=tercihetmek
add=eklemek
accept=kabuletmek
refuse=reddedmek
aegree=ayný fikirde olmak
ask=soru sormak
ansver=cevap vermek
arrive=varmak,ulaþmak
attack=saldýrý
start=baþlamak
begin=baþlamak
breal=kýrmak
leave=ayrýlma teklif etmek
miss=özlemek
call=aramak
catch=yakalamak
cut=kesmek
kill=öldürmek
die=ölmek
explain=açýklamak
feel=hissetmek
smile=gülümsemek
fall=düþmek
forget=unutmak
forgive=affetmek
help=yardým etmek
meet=toplanmak
natice=parketmek
offer=teklif etmek
order=sýpariþ etmek
pick=toplamak
plan=plan
quit=terketmek
record=kaybetmek
remember=hatýrlamak
reply=tekrar
rect=dinlenmek
ria=zilcalmak
shake=çalkalamak
shut=kapatmak
sleep=uyumak
talk=konuþmak
tavan=dokunma
trever=seyhat
try=çalýþmak
visit=ziyaret
wear=giyim
work=çalýþan
worry=endiþe
win=birincilik
worh=çalýþan
wait=bekle
use=kullanmak